11111111111111
10010000C00001
100P0111110001
10001100E00001
11111111111111
