11111111111111
1000C000000001
10000111111101
1P001000E00001
11111111111111
