11111111111111
10000C00C00001
10C00111111001
1P001000E00001
11111111111111
