11111111111111
10000C00C00001
10C00111110001
1P001000E0C001
11111111111111
